4
Rocking Around
w,w,w,w,w,w,w,w
w,w,o,o,o(e),o,o,w
w,w,o,o(b),o,o(b),o,w
w,w,o,o(b),o(b),o(b),o,w
w,w,o,o,o(b),o,o,w
w,w,o,o,o(b),o,o,w
w,w,w,w,w,w,w,w
w,s,s,s,s,s,o,w
w,o,o(x),w,o,o,o,w
w,w,w,w,w,w,w,w